111111111111111111111
101101111001111111111
100000000011111111111
101101011111111101111
101100111000110001111
101101111011111101111
101110000000000001111
100110111001111011011
110000111111111000011
111111111111111111111